[charmtools.templates]
python = charmtools.templates.python_services:PythonServicesCharmTemplate
chef = charmtools.templates.chef:ChefCharmTemplate
python-basic = charmtools.templates.python:PythonCharmTemplate
ansible = charmtools.templates.ansible:AnsibleCharmTemplate
bash = charmtools.templates.bash:BashCharmTemplate

[console_scripts]
charm-test = charmtools.test:main
charm-refresh = charmtools.build:deprecated_main
charm-proof = charmtools.proof:main
charm-list = charmtools.list:main
charm-subscribers = charmtools.subscribers:main
charm-add = charmtools.generate:main
charm-inspect = charmtools.build:deprecated_main
charm-review-queue = charmtools.review_queue:main
charm-unpromulgate = charmtools.unpromulgate:main
charm-getall = charmtools.getall:main
charm-info = charmtools.info:main
charm-create = charmtools.create:main
charm-layers = charmtools.build:inspect
juju-bundle = charmtools:bundle
charm-compose = charmtools.build:deprecated_main
charm-generate = charmtools.build:deprecated_main
charm-review = charmtools.review:main
charm-get = charmtools.get:main
charm = charmtools:charm
charm-search = charmtools.search:main
charm-update = charmtools.update:main
charm-version = charmtools.version:main
charm-help = charmtools.cli:usage
charm-build = charmtools.build:main
juju-test = charmtools.test:main
juju-charm = charmtools:charm
charm-promulgate = charmtools.promulgate:main

